# Test map for duck game
# map is 0 indexed
# 0 = grass, 1 = wall, 2 = water
WIDTH=30
HEIGHT=14
SPAWN_X=1
SPAWN_Y=1
DATA=
111111111111111111111111111111
100000000000002222222222222201
111111000111111111111111111111
111111101222222222222222222221
111111101222222222222222222221
111111101111111111111111111111
100000000000000122222222222221
100002222200000122222220022221
100002000200100011222200002221
100002020200100000000000000001
100002000200100011222200002221
100002222200000122222220022221
100000000000000122222222222221
111111111111111111111111111111