# test2
# 0 = grass, 1 = wall, 2 = water
WIDTH=50
HEIGHT=40
SPAWN_X=1
SPAWN_Y=38
DATA=
11111111111111111111111111111111111111111111111111
10011022222222222222222222222222222222222222222221
10001111222211111111111111111111111222222222222221
10100001222212222222222222222222221222222222222221
10100001111112000000000000000000021111111111111121
10100000000112000000000000000000021200002200002121
10111111000002000022222222222000021200000000002121
10122221110002000020000000002000021220000000022121
10122222211112000020222222202000021222222222222121
10120000000012000020200000202000021222222222222121
10122222200012000020202220202000021000000000000121
10122222222212000020202020202000021000000000000121
10122211111112000020202220202000021000000000000121
10111111111112000020200000202000021000000000000121
10111111111112000020222222202000021000000000000121
10111111111112000020000000002000021000001000000121
10111111111112000022222222222000021000000100000121
10111111111112000000000000000000021000000010010121
10111111111112222222222222222222221000000001010121
10111111111111111111111111111111111000000000110121
10000010000000110000000000000000000000000011110121
10010010001000100110000011110000000000000000000021
10110110011001101110000012210000000000000000000121
11100100010001001010000112210000000000000000000121
10000100110011001010000122210000000000000000000121
10011000100110001010001122210000000000000000000121
10110001001100011010111222210000000000000000000121
10000011011000010010100222210000000000000000000121
10000110000000110010000222210000000000000000000121
10010101010001100010000222210000000000000000000121
10101010101111112211111112220000000000000000000121
11000000000111112211111112220000000000000000000121
12000111001111112211111112221100000000000001100121
12200121000111110011111110000010001000100010000121
12220111001111110011111110000001010101010100000121
12222000000111111111111110000001110000011100000121
12222200001111110011111110000000001010100000000121
12222220000101000000000000000000000222000000000121
10222222000000000000000000000000000000000000000101
11111111111111111111111111111111111111111111111111
