# Test map for duck game
# 0 = grass, 1 = wall, 2 = water
WIDTH=16
HEIGHT=9
DATA=
1111111011111111
1000000000000001
1000022222000001
1000020002001000
1000020202001000
1000020002001000
1000022222000001
1000000000000001
1111111111111111